NO ./textures/42_N.png
SO ./textures/42_S.png
EA ./textures/42_E.png
WE ./textures/42_W.png
DO ./textures/42_DO.png
PO ./textures/42_PO.png

C  0,0,0
F  255,255,255

111111111111111111111111111111111111111111111111111111111111111
100000000000000000000000000000000000000000000000000000000000001
100000000000000000000000000000000000000000000000000000000000001
100000000000000000000000000000000000000000000000000000000000001
100000000000000000000000000000000P00000000000000000000000000001
100000000000000000000000000000000000000000000000000000000000001
100000000000000000000000000000000000000000000000000000000000001
100000000000000000000000000000000000000000000000000000000000001
100000000000000000000000000000000000000000000000000000000000001
100000000000000000000000000000000000000000000000000000000000001
100000000000000000000000000000000000000000000000000000000000001
100000000000000000000000000000000000000000000000000000000000001
100000000000000000000000000000000000000000000000000000000000001
100000000000000000000000000000000000000000000000000000000000001
100000000000000000000000000000000000000000000000000000000000001
100000000000000000000000000000000000000000000000000000000000001
100000000000000000000000000000000000000000000000000000000000001
100000000000000000000000000000000000000000000000000000000000001
100000000000000000000000000000000000000000000000000000000000011
100000000000000000000000000000000000000000000000000000000000101
100000000000000000000000000000000000000000000000000000000001001
100000000000000000000000000000000000000000000000000000000010001
100000000000000000000000000000000000000000000000000000000100001
100000000000000000000000000000000000000000000000000000001000001
111111100000000000000000000000000000000000000000000000010000001
100000100000000000000000000000000000000000000000000000100000001
100111111111111111111100000000000000000000000000000001000000001
100000000000000000000010000000000000000000000000000010000000001
100111111111111111111001000000000000000000000000000100000000001
1000001000000000000001001000000000000111D1111111111000001100001
111111100000000000000010010000000000010000111111110000001100001
10000000000000000000000100100000000001D111111111100000001100001
100001111000000100000000100111000111100000111111000000001100001
100001  100000010000000000D000111000D00001111110000000001100001
100001  1000000100000000001000010000100000000100000000001100001
100001  1000000100000000000100000001000000001000000000001100001
100001  1000000100000000000010000010000000010000000000001100001
100001  1000000100000000000010000010000000100000000000001100001
100001  10000001000000000000100N0010000001000000000000001100001
100001  1000000100000000000010000010000010000000000000001100001
100001111000000100000000000010000010000100000001111111111100001
100000000000000100000000000100000001001000000011111111111100001
111111111111111111111111111000010000110000000111111111111100001
10000000000000000000000000D000111000D00000001111111111111100001
100000000000000000000000000111000111000000011111111111111100001
100001111111111111111111111000000000000000000000000000000000001
100000000000000000000000001000000000000000000000000000000000001
1111111111111111111111111D1000000000000000000000000000000000001
100000000000000000000000001000000000000000000000000000000000001
100001111111111111111111111000000000000000000000000000000000001
100000000000000000000000001000000000000000000000000000000000001
1111111111111111111111111D1000000000011111111111111111110000001
10000000000000000000000000100000000001                 10000001
10000111111111111111111111100000000001         11111   10000001
10000000000000000000000000100000000001        11111    10000001
1111111111111111111111111D100000000001       11111     10000001
10000000000000000000000000100000000001      11111      10000001
10000111111111111111111111100000000001     11111       10000001
10000000000000000000000000100000000001    11111        10000001
1111111111111111111111111D100000000001   11111         10000001
10000000000000000000000000100000000001                 10000001
100001111111111111111111111000000000011111111111111111110000001
100000000000000000000000001000000000000000000000000000000000001
111111111111111111111111111111111111111111111111111111111111111