NO ./textures/black_background_1.png
SO ./textures/black_background_2.png
WE ./textures/black_background_3.png
EA ./textures/black_background_1.png
DO ./textures/black_background_61.png
PO ./textures/black_background_5.png

F  150,150,150
C  100,100,100

111111111111111111111111111111111111111111
1000000000000000000000000000000000000000P1
100000000000000000000000000000000000000001
100000000000000000000000000000000000000001
100000000000000000000000000000000000000001
100000000000000000000000000000000000000001
100000000000000000000000000000000000000001
100000000000000000000000000000000000000001
101000000000000000000000000000000000000001
10100000000001D100000000000000000000000001
111111111111100010000000000000000000000001
100000001100000010000000000000000000000001
100010001100000100000000000000000000000001
100010001100000100000000000000000111111111
100011D11100001100000000000000000100000001
100010001100001000000000000000000100000101
111D11001000001000000000000000000100000101
100001001000011111111111111111111100000101
1000010010000000000000000000000000000011D1
100001001000000000000000000000000000001001
10N001001111111111111111111111111111111001
10000100D000000000000000000000000000000001
111111111111111111111111111111111111111111