NO ./textures/asset1.png
SO ./textures/asset1.png
WE ./textures/asset2.png
EA ./textures/asset2.png
DO ./textures/backdrop.png
PO ./textures/backdrop.png

F  220,100,3
C  225,30,10


        1111111111111111111111111
        1000000000110000000000001
        1011000001110000000000001
        1001000000000000000000001
111111111011000001110000000000001
100000000011000001110111111111111
11110111111111011100000010001
11110111111111011101010010001
11000P00110101011100000010001
100000000000000011000000D0001
10000000000000001101010010001
11000001110101011111011110N0111
11110111 1110101 101111010001
11111111 1111111 111111111111